#music assets/sounds/Ain.mp3
17 17 17 17 17 17 17 17 16 16 16 16 16 16 16 16
17 245 1 247 247 246 247 244 245 17 0 0 0 16 16 16
17 261 1 263 17 262 16 16 261 17 0 0 0 0 16 16
17 16 278 16 279 16 279 16 277 17 0 0 0 0 16 16
17 1 294 17 295 17 295 1 293 17 0 0 0 0 16 16
17 309 310 311 311 310 311 1 16 17 0 0 0 0 16 16
17 1 326 17 327 326 17 1 325 17 0 0 0 0 16 16
17 1 342 17 343 342 1 340 341 17 0 0 0 0 16 16
17 1 262 17 263 262 17 260 261 17 0 0 0 0 16 16
17 33 33 33 33 33 33 33 33 33 33 33 33 33 33 33
17 33 33 33 33 33 33 33 33 33 33 33 33 33 33 33
17 16 16 311 311 310 311 308 309 17 0 0 0 0 16 16
17 325 326 327 327 326 327 324 16 17 0 0 0 0 16 16
17 16 342 343 343 342 343 340 16 17 0 0 0 0 16 16
17 16 50 50 49 49 50 49 16 17 0 0 0 0 16 16
17 16 66 66 65 65 16 16 66 17 0 0 0 0 16 16
17 17 17 17 17 17 17 17 17 16 16 16 16 16 16 16
97 98 98 98 97 97 98 97 98 97 0 0 0 0 0 0
113 114 114 114 113 113 114 113 114 113 0 0 0 0 0 0
129 130 130 130 129 129 130 129 130 1 1 1 1 0 0 1

#collision
0 0 0 0 0 0 0 0 0 0 0 0 0 0 0 0
0 0 0 0 0 0 0 0 0 0 0 0 0 0 0 0
0 0 0 0 0 0 0 0 0 0 0 0 0 0 0 0
0 0 0 0 0 0 0 0 0 0 0 0 0 0 0 0
0 0 0 0 0 0 0 0 0 0 0 0 0 0 0 0
0 0 0 0 0 0 0 0 0 0 0 0 0 0 0 0
0 0 0 0 0 0 0 0 0 0 0 0 0 0 0 0
0 0 0 0 0 0 0 0 0 0 0 0 0 0 0 0
0 0 0 0 0 0 0 0 0 0 0 0 0 0 0 0
0 0 0 0 0 0 0 0 0 0 0 0 0 0 0 0
0 0 0 0 0 0 0 0 0 0 0 0 0 0 0 0
0 0 0 0 0 0 0 0 0 0 0 0 0 0 0 0
0 0 0 0 0 0 0 0 0 0 0 0 0 0 0 0
0 0 0 0 0 0 0 0 0 0 0 0 0 0 0 0
0 0 0 0 0 0 0 0 0 0 0 0 0 0 0 0
0 0 0 0 0 0 0 0 0 0 0 0 0 0 0 0
0 0 0 0 0 0 0 0 0 0 0 0 0 0 0 0
0 0 0 0 0 0 0 0 0 0 0 0 0 0 0 0
0 0 0 0 0 0 0 0 0 0 0 0 0 0 0 0
0 0 0 0 0 0 0 0 0 0 0 0 0 0 0 0
